NO ./textures/north_wall/mario_cube.xpm
SO    ./textures/south_wall/mario_bush.xpm
F 200,76,12
WE ./textures/west_wall/mario_brick.xpm
EA ./textures/east_wall/mario_cloud.xpm



C 115,160,240

1111111
1100011
1111111
        1111111111111111111111111
        1000000000110000000000001
        1011000001110000001000001
        1001000000000000000000001
111111111011000001110000000000001
100000000011000001110111110111111
11110111111111011100000010001
11110111111111011101010010001
11000000110101011100000010001
10001000000000001100000010001
10000000000000001101010010001
11000001110101011111011110N0111
11110111 1110101 101111010001
11111111 1111111 111111111111