NO ./textures/east_wall/cake.xpm
SO ./textures/east_wall/cake.xpm
WE ./textures/east_wall/cake.xpm  
EA ./textures/east_wall/cake.xpm

F 210,159,105
C 207,226,243

        1111111111111111111111111
        1000000000110000000000001
        1011000001110000000000001
        1001000000000000000000001
111111111011000001110000000000001
100000000011000001110111110111111
10000000000000000000000000001
100000000000000000000000000011
10000000000000000000000000001
10000000000000000000000000001
10000000000000001111111100001
10000000000000000000000000001
10000111011000000000000000001
10000000000000000000000000001
10000000000000000000000000001
10000011111111110000110000001
10000011000000000000000000001
10000000000000000000000000001
10000000000000000000000000001
10000000000000000000000000001
10000000000000000000000000001
10000000000000000000000000001
10000000000000000000000000001
10000000000000000000000000001
10000000000000000000000000001
10000000000000000000000000001
10000000000000000000000000001
10000000000000000000000000001
10000000000000000000000000001
10000000000000000000000000001
10000000000000000000000000001
10000000000000000000000000001
10000000000000000000000000001
10000000000000000000000000001
10000000000000000000000000001
10000000000000000000000000001
10000000000000000000000000001
10000000000000000000000000001
10000000000000000000000000001
10000000000000000000000000001
10000000000000000000000000001
10000000000000000000000000001
10000000000000000000000000001
10000000000000000000000000001
10000000000000000000000000001
1N0000000000000000000000000011
11110111111111011100000010001
11110111111111011101010010001
11000000110101011100000010001
10000000000000001100000010001
10000000000000001101010010001
1100000111010101111101111000111
11110111 1110101 101111010001
11111111 1111111 111111111111