NO ./textures/north_wall/mario_cube.xpm
                                SO ./textures/north_wall/mario_cube.xpm

   WE ./textures/north_wall/mario_cube.xpm  
EA ./textures/north_wall/mario_cube.xpm

F 220,100,0
C 225,30,0

     111111111111
111110000001
100000000000
111111111111