NO ./textures/north_wall/mario_cube.xpm
SO ./textures/north_wall/mario_cube.xpm
WE ./textures/north_wall/mario_cube.xpm  
EA ./textures/north_wall/mario_cube.xpm

F 20,20,20
C 200,200,200


        1111111111111111111111111
        1000000000110000000000001
        1011000001110000000000001
        1001000000000000000000000
111111111011000001110000000000001
100000000011000001110111110111111
11110111111111011100000010001
11110111111111011101010010000
11000000110101011100000010001
10000000000000001100000010001
10000000000000001101010010001
11000001110101011111011110N0111
11110111 1110101 101111010001
11111111 1111111 111111111111
